//####////
###  ####/
#     $ #/
# #  #$ #/
# . .#@ #/
#########/