///////####//////
////####  #//////
///##  #  #//////
///#  $ $ #//////
/### #$   ####///
/#  $  ##$   #///
/#  # @ $ # $#///
/#  #      $ ####
/## ####$##     #
/# $#.....# #   #
/#  $...*. $# ###
##  #.....#   #//
#   ### #######//
# $$  #  #///////
#  #     #///////
######   #///////
/////#####///////