//#########//
//#*.*#*.*#//
//#.*.*.*.#//
//#*.*.*.*#//
//#.*.*.*.#//
//#*.*.*.*#//
//###   ###//
////#   #////
###### ######
#           #
# $ $ $ $ $ #
## $ $ $ $ ##
/#$ $ $ $ $#/
/#   $@$   #/
/#  #####  #/
/####///####/