################/
#              #/
# # ######     #/
# #  $ $ $ $#  #/
# #   $@$   ## ##
# # #$ $ $###...#
# #   $ $  ##...#
# ###$$$ $ ##...#
#     # ## ##...#
#####   ## ##...#
////#####     ###
////////#     #//
////////#######//