////#########///////
//###   ##  #####///
###      #  #   ####
#  $$ #$ #  #  ... #
# #  $#@$## # #.#. #
#  ## #$  #    ... #
# $#    $ # # #.#. #
#    ##  ##$ $ ... #
# $ ##   #  #$#.#. #
## $$  $   $  $... #
/#$  ######    ##  #
/#   #    ##########
/#####//////////////