//////////#######
//////////#  ...#
//////#####  ...#
//////#      ...#
//////#  ##  ...#
//////## ##  ...#
/////### ########
/////# $$$ ##////
/#####  $ $ #####
##   #$ $   #   #
#@ $  $    $  $ #
###### $$ $ #####
/////# $    #////
/////#### ###////
////////#  #/////
////////#  #/////
////////#  #/////
////////####/////