#####/////////
#   ##////////
#    #  ####//
# $  ####  #//
#  $$ $   $#//
###@ #$    ##/
/#  ##  $ $ ##
/# $  ## ## .#
/#  #$##$  #.#
/###   $..##.#
//#    #.*...#
//# $$ #.....#
//#  #########
//#  #////////
//####////////