//####//////////
//#  ###########
//#    $   $ $ #
//# $# $ #  $  #
//#  $ $  #    #
### $# #  #### #
#@#$ $ $  ##   #
#    $ #$#   # #
##  $    $ $ $ #
/####  #########
//###  ###//////
//#      #//////
//#      #//////
//#......#//////
//#......#//////
//#......#//////
//########//////