#########//////
#       #//////
#       ####///
## #### #  #///
## #@##    #///
# $$$ $  $$#///
#  # ## $  #///
#  # ##  $ ####
####  $$$ $#  #
/#   ##   ....#
/# #   # #.. .#
/#   # # ##...#
/##### $  #...#
/////##   #####
//////#####////