//////////////////////
/////#####////////////
/////#   #////////////
/////#$  #////////////
///###  $##///////////
///#  $ $ #///////////
/### # ## #///######//
/#   # ## #####  ..#//
/# $  $          ..#//
/##### ### #@##  ..#//
/////#     #########//
/////#######//////////
//////////////////////