/#################/////
/#...   #    #   ###///
##.....  $## # # $ #///
#......#  $  #  $  #///
#......#  #  # # # ##//
######### $  $ # #  ###
//#     #$##$ ## ##   #
/##   $    # $  $   # #
/#  ## ### #  #####$# #
/# $ $$     $   $     #
/# $    $##$ ######## #
/#######  @ ##      ###
///////######//////////