/////#######///
/////#@ #  #///
/////# $   #///
////### ## #///
/#### $  # ##//
/#       #  ##/
/# $ $#### $ #/
/# $$ #  #  $#/
/#$  $   #$  #/
##  $$#   $$ ##
# $$  #  #  $ #
#     #### $  #
#  #$##..##   #
### .#....#####
//# .......##//
//#....   ..#//
//###########//