////////////####//////
/############  #####//
/#    #  #  $  #   ##/
/# $ $ $  $ # $ $   #/
/##$ $   # @# $   $ #/
###   ############ ##/
#  $ $#  #......# $#//
# #   #  #......## #//
#  ## ## # .....#  #//
# #      $...... $ #//
# # $ ## #......#  #//
#  $ $#  #......# $#//
# $   #  ##$#####  #//
# $ $ #### $ $  $ $#//
## #     $ $ $ $   ###
/#  ###### $    $    #
/#         # ####### #
/####### #$          #
///////#   ###########
///////#####//////////