///##########////////
///#........####/////
///#.#.#....#  #/////
///#........$$ #/////
///#     .###  ####//
/#########  $ #   #//
/#     $   $ $  $ #//
/#  #    #  $ $#  #//
/## #####   #  #  #//
/# $     #   #### #//
##  $#   # ##  #  #//
#    ##$###    #  ##/
# $    $ #  #  #   #/
#####    # ## # ## ##
////#$# #  $  $ $   #
////#@#  $#$$$  #   #
////###  $      #####
//////##  #  #  #////
///////##########////