///##########///
///#..  #   #///
///#..      #///
///#..  #  ####/
//#######  #  ##
//#            #
//#  #  ##  #  #
#### ##  #### ##
#  $  ##### #  #
# # $  $  # $  #
# @$  $   #   ##
#### ## #######/
///#    #///////
///######///////