/////####/////////
///###  ##////////
####  $  #////////
#   $ $  ####/////
# $   # $   # ####
#  #  #   $ # #..#
##$#$ ####$####..#
/#   ##### ## ...#
/#$# ##@## ##  ..#
/# #    $     ...#
/#   #### ###  ..#
/### ## #  ## ...#
//##$ ####$ ###..#
//#   ##    # #..#
/## $$##  $ # ####
/#     $$$$ #/////
/# $ ###    #/////
/#   #/######/////
/#####////////////