############//######
#   #    #@####....#
#   $$#       .....#
#   # ###   ## ....#
## ## ###  #   ....#
/# $ $     # ## ####
/#  $ $##  #       #
#### #  #### ## ## #
#  # #$   ## ##    #
# $  $  # ## #######
# # $ $    # #//////
#  $ ## ## # #//////
# $$     $$  #//////
## ## ### $  #//////
/#    #/#    #//////
/######/######//////