###########//////////
#......   #########//
#......   #  ##   #//
#..### $    $     #//
#... $ $ #  ###   #//
#...#$#####    #  #//
###    #   #$  # $###
//#  $$ $ $  $##  $ #
//#  $   #$#  ##    #
//### ## #  $ #######
///#  $ $ ## ##//////
///#    $  $  #//////
///##   # #   #//////
////#####@#####//////
////////###//////////