//////####///
//#####  #///
/##     $#///
## $  ## ###/
#@$ $ # $  #/
#### ##   $#/
/#....#$ $ #/
/#....#   $#/
/#....  $$ ##
/#... # $   #
/######$ $  #
//////#   ###
//////#$ ###/
//////#  #///
//////####///