/####//////////
/#######///////
/#  #  #####///
##  #  #...###/
#  $#  #...  #/
# $ #$$ ...  #/
#  $#  #... .#/
#   # $########
##$       $ $ #
##  #  $$ #   #
/######  ##$$@#
//////#      ##
//////########/