#####/####///////
#...#/#  ####////
#...###  $  #////
#....## $  $###//
##....##   $  #//
###... ## $ $ #//
# ##    #  $  #//
#  ## # ### ####/
# $ # #$  $    #/
#  $ @ $    $  #/
#   # $ $$ $ ###/
#  ######  ###///
# ##////####/////
###//////////////