////////////////#####///
///////###### ###   ####
///#####    ### $ $  $ #
####  ## #$ $    $ #   #
#....   $$ $ $  $   #$##
#.. # ## #   ###$## #  #
#....    # ###    #    #
#....    # ##  $  ###$ #
#..######  $  #  #### ##
####    #   ###    @  #/
////////###############/