/#########////
/#....   ##///
/#.#.#  $ ##//
##....# # @##/
# ....#  #  ##
#     #$ ##$ #
## ###  $    #
/#$  $ $ $#  #
/# #  $ $ ## #
/#  ###  ##  #
/#    ## ## ##
/#  $ #  $  #/
/###$ $   ###/
///#  #####///
///####///////