/#####/////////////
/#   #/////////////
/# # ######////////
/#      $@######///
/# $ ##$ ###   #///
/# #### $    $ #///
/# ##### #  #$ ####
##  #### ##$      #
#  $#  $  # ## ## #
#         # #...# #
######  ###  ...  #
/////#### # #...# #
//////////# ### # #
//////////#       #
//////////#########