///////////#####////
//////////##   ##///
/////////##     #///
////////##  $$  #///
///////## $$  $ #///
///////# $    $ #///
####   #   $$ #####/
#  ######## ##    #/
#..           $$$@#/
#.# ####### ##   ##/
#.# #######. #$ $###
#........... #   $ #
##############  $  #
/////////////##  ###
//////////////####//