////#########//####///
////#   ##  ####  #///
////#   $   #  $  #///
////#  # ## #     ####
////## $   $ $$# #   #
////####  #  # $ $   #
#####  ####    ###...#
#   #$ #  # ####.....#
#      #  # # ##.....#
###### #  #$   ###...#
///#   ## # $#   #...#
//##       $  $# #####
/## $$$##  # $   #////
/#   #  # ###  ###////
/#   $  #$ @####//////
/#####  #   #/////////
/////########/////////