////////#######////
////#####  #  ####/
////#   #   $    #/
/#### #$$ ## ##  #/
##      # #  ## ###
#  ### $#$  $  $  #
#...    # ##  #   #
#...#    @ # ### ##
#...#  ###  $  $  #
######## ##   #   #
//////////#########