//////////////######///////
//////////#####    #///////
//////////#  ## #  #####///
//////////#   *.#..#   #///
/##### #### $#.#...    #///
/#   ###  ## #*....## ##///
/# $      ## #..#..## #////
###### #   # #*.##### #////
#   # $#$# # #..##### #////
# $  $     # #*.    # #////
## ##  $ ### #  ##  # #////
/#  $  $ ### ##### ## #////
/###$###$###  #### ## #////
#### #         ###  # #////
#  $ #  $####  ###$$#@#####
#      $ # #  ####  #$#   #
#### #  $# #              #
///#  $  # ##  ##  ########
///##  ###  ########///////
////####///////////////////