/#####################/
/#   ##  #   #   #   #/
/# $     $   $   $   ##
##### #  #   ### ##$###
#   # ##$######   #   #
# $   # ......#   # $ #
## #  # ......#####   #
## #########..#   # ###
#          #..# $   #//
# ## ### ###..## #  ###
# #   #   ##..## ###  #
#   @      $..#       #
# #   #   ##  #   ##  #
##### ############## ##
#          #   #    $ #
# $  # $ $ $   # #    #
# #$## $#  ## ##    # #
#  $ $$ #### $  $ # # #
#          #   #      #
#######################