/////////////////
////////########/
////////#     @#/
////////# $#$ ##/
////////# $  $#//
////////##$ $ #//
######### $ # ###
#....  ## $  $  #
##...    $  $   #
#....  ##########
########/////////
/////////////////