/////#############///
/////#    ###    #///
/////#     $ $  ####/
///#### #   $ $    #/
//## $  #$#### $ $ #/
###   # #   ###  $ #/
# $  $  #  $  # ####/
# ##$#### #$#  $  ###
# ##  ### # # #  $  #
#    @$   $   # $ # #
#####  #  ##  # $#  #
//#... #####$  #  # #
//#.......# $$ #$ # #
//#.......#         #
//#.......#######  ##
//#########/////####/