//////////////########
//////////////#  ....#
///############  ....#
///#    #  $ $   ....#
///# $$$#$  $ #  ....#
///#  $     $ #  ....#
///# $$ #$ $ $########
####  $ #     #///////
#   # #########///////
#    $  ##////////////
# $$#$$ @#////////////
#   #   ##////////////
#########/////////////