/////////####////////////////
/////////#  #////////////////
/////////#  ########/////////
///#######  #      #/////////
///#   # # # # #   ##////////
///# $     $  ##  $ #////////
//### $# #  # #     #########
//#  $  #  $# # $$ #   # #  #
/## #   #     ###    $ # #  #
/#  #$   # ###  #  # $$# #  #
/#    $## $  #   ## $  # # ##
####$ $ #    ##  #   $    ..#
#  #    ### # $ $ ###  ###.*#
#     ##  $$ @  $     ##....#
#  ##  ##   $  #$#  ##....*.#
## #  $  # # $##  ##....*.###
## ##  $  # $ #  #....*.###//
#    $ ####   # ....*.###////
#   #  #//#  #  ..*.###//////
########//###########////////