////////#####////
////////#   #####
////////# #$##  #
////////#     $ #
######### ###   #
#....  ## $  $###
#....    $ $$ ##/
#....  ##$  $ @#/
#########  $  ##/
////////# $ $  #/
////////### ## #/
//////////#    #/
//////////######/