######//###/
#..  #/##@##
#..  ###   #
#..     $$ #
#..  # # $ #
#..### # $ #
#### $ #$  #
///#  $# $ #
///# $  $  #
///#  ##   #
///#########
