///////#######////
/#######     #////
/#     # $@$ #////
/#$$ #   #########
/# ###......##   #
/#   $......## # #
/# ###......     #
##   #### ### #$##
#  #$   #  $  # #/
#  $ $$$  # $## #/
#   $ $ ###$$ # #/
#####     $   # #/
////### ###   # #/
//////#     #   #/
//////########  #/
/////////////####/