//////////####/////
/////#### #  #/////
///###  ###$ #/////
//##   @  $  #/////
/##  $ $$## ##/////
/#  #$##     #/////
/# # $ $$ # ###////
/#   $ #  # $ #####
####    #  $$ #   #
#### ## $         #
#.    ###  ########
#.. ..# ####///////
#...#.#////////////
#.....#////////////
#######////////////