//////////////####///
/////////######  #///
/////////#       #///
/////////#  #### ###/
/###  ##### ###    #/
##@####   $$$ #    #/
# $$   $$ $   #....##
#  $$$#    $  #.....#
# $   # $$ $$ #.....#
###   #  $    #.....#
//#   # $ $ $ #.....#
//# ####### ###.....#
//#   #  $ $  #.....#
//### # $$ $ $#######
////# #  $      #////
////# # $$$ $$$ #////
////# #       # #////
////# ######### #////
////#           #////
////#############////