///////############/
///////#..........#/
/////###.#.#.#.#..#/
/////#   .........#/
/////#@ $ $ $ *.*.#/
////####### #######/
/####   #    ##  #//
##    $ #    # $ ##/
#  #$# ### ###$   ##
# $  $ $   # $ $ $ #
#  # $ ##       #$ #
#   $####$####$##  #
####  ##   #    #  #
///#$ ##   # # $$  #
///#   # $ #  $    #
///### # $$ #  $ ###
/////# #    # $ ##//
/////# ######## #///
/////#          #///
/////############///