///////#######///////////
///////#  #  ####////////
///////# $#$ #  ##///////
########  #  #   ########
#....  # $#$ #  $#  #   #
#....# #     #$  #      #
#..#.    $#  # $    #$  #
#... @##  #$ #$  #  #   #
#.... ## $#     $########
########  #$$#$  #///////
///////# $#  #  $#///////
///////#  #  #   #///////
///////####  #####///////
//////////####///////////