////////######//////////////
////////#   @####///////////
//////##### $   #///////////
//////#   ##    ####////////
//////# $##  ##    #////////
//////#   #  ##### #////////
//////# #$$ $    # #////////
//////#  $ $ ### # #////////
//////# #   $  # # #////////
//////# #  #$#   # #////////
/////## ####   # # #////////
/////#  $  ##### # # ####///
////##    $     $  ###  ####
#####  ### $ $# $ #   .....#
#     ##      #  ##  #.....#
# $$$$    ######$##   #.##.#
##    ##              #....#
/##  ###############   ....#
//#  #/////////////#####  ##
//####/////////////////####/