//////############////
//////#  .  ##   #////
//////# #.     @ #////
/###### ##...# ####///
##  ##...####     ####
# $ ##...    $ #  $  #
#     .. ## # ## ##  #
####$###$# $  #   # ##
/###  #    ##$ $$ # #/
/#   $$ # # $ # $## #/
/#                  #/
/#################  #/
/////////////////####/