/#####////////
/#   #######//
/# $ ###   #//
/# $    $$ #//
/## ####   #//
### #  # ###//
#   #  #@##///
# $$    $ #///
#   # # $ ####
##### #   #  #
/#   $####   #
/#  $     $  #
/##   ##### ##
/##########  #
##....# $  $ #
#.....# $$#  #
#.. ..# $  $ #
#.....$   #  #
##############