//####////////////
//#  #########////
/##  ## @#   #////
/#  $# $ $   ####/
/#$  $  # $ $#  ##
##  $## #$ $     #
#  #  # #   $$$  #
# $    $  $## ####
# $ $ #$#  #  #///
##  ###  ###$ #///
/#  #....     #///
/####......####///
///#....####//////
///#...##/////////
///#...#//////////
///#####//////////