/########////
/#@##   ####/
/# $   $   #/
/#  $ $ $$$#/
/# $$# #   #/
##$    $   #/
#  $  $$$$$##
# $#### #   #
#  $....#   #
# ##....#$$ #
# ##....   ##
#   ....#  #/
## #....#$$#/
/# #....#  #/
/#         #/
/#### ##$###/
////#    #///
////######///