////############/
////#          ##
////#  # #$$ $  #
////#$ #$#  ## @#
///## ## # $ # ##
///#   $ #$  # #/
///#   # $   # #/
///## $ $   ## #/
///#  #  ##  $ #/
///#    ## $$# #/
######$$   #   #/
#....#  ########/
#.#... ##////////
#....   #////////
#....   #////////
#########////////