//////####/
####### @#/
#     $  #/
#   $## $#/
##$#...# #/
/# $...  #/
/# #. .# ##
/#   # #$ #
/#$  $    #
/#  #######
/####//////