///////####/////
///////#  ##////
///////#   ##///
///////# $$ ##//
/////###$  $ ##/
//####    $   #/
###  # #####  #/
#    # #....$ #/
# #   $ ....# #/
#  $ # #.*..# #/
###  #### ### #/
//#### @$  ##$##
/////### $     #
///////#  ##   #
///////#########