//////////////###//////
/////////////##.###////
/////////////#....#////
/#############....#////
##   ##     ##....#####
#  $$##  $ @##....    #
#      $$ $#  ....#   #
#  $ ## $$ # #....#  ##
#  $ ## $  # ## ###  #/
## ##### ###         #/
##   $  $ ##### ###  #/
# $###  # ##### # ####/
#   $   #       #//////
#  $ #$ $ $###  #//////
# $$$# $   # ####//////
#    #  $$ #///////////
######   ###///////////
/////#####/////////////