############//
#..  #     ###
#..  # $  $  #
#..  #$####  #
#..    @ ##  #
#..  # #  $ ##
###### ##$ $ #
//# $  $ $ $ #
//#    #     #
//############