//////######/////////////
///#####   #/////////////
///#   # # #####/////////
///# $ #  $    ######////
//##$  ### ##       #////
###  $$ $ $ #  ##   #####
#       $   ###### ##   #
#  ######## #@   # #  # #
## ###      #### #$# #  #
/# ### #### ##.. #   $ ##
/#  $  $  #$##.. #$##  ##
/#  # # #     ..## ## $ #
/####   # ## #..#    $  #
////#####    #..# # #  ##
////////######..#   # ##/
/////////////#..#####  #/
/////////////#..       #/
/////////////##  ###  ##/
//////////////#########//