/####////////////////
##  #####////////////
#       # #####//////
# $###  ###   #//////
#..#  $# #  # #//////
#..#      $$# ###////
#.*# #  #$ $    #####
#..#  ##     ##$#   #
#.*$  $ # ##  $     #
#..##  $   #   ######
#.*##$##   #####/////
#..  $ #####/////////
#  # @ #/////////////
########/////////////