/#####################
##                   #
#    $ #      ## #   #
#  ###### ###  #$## ##
##$#   ##$#....   # #/
#  #    $ #....## # #/
# $ # # # #....##   #/
# $ #$$   #....##$# #/
# # $@$##$#....##   #/
#   $$$   #....#    #/
#  $#   # ###### $###/
##  # ###$$  $   $ #//
##     # $  $ ##   #//
/#####   #   #######//
/////#########////////