##########////
#        ####/
# ###### #  ##
# # $ $ $  $ #
#       #$   #
###$  $$#  ###
//#  ## # $##/
//##$#   $ @#/
///#  $ $ ###/
///# #   $  #/
///# ##   # #/
//##  ##### #/
//#         #/
//#.......###/
//#.......#///
//#########///