///##########
///#  ###   #
///# $   $  #
///#  ####$##
///## #  #  #
//##  #.*   #
//#  ##..#  #
//# @ #.*# ##
//# #$#..#$ #
//# $ #..#  #
//# # #**#  #
//# $ #..#$##
//#    .*#  #
/###  #  #  #
##    ####  #
#  #######$##
# $      $  #
#  ##   #   #
#############