/////////####/////
/#########  ##////
##  $      $ #####
#   ## ##   ##...#
# #$$ $ $$#$##...#
# #    @  #   ...#
#  $# ###$$   ...#
# $  $$  $ ##....#
###$       #######
//#  #######//////
//####////////////