//////############/
/////##..    #   #/
////##..* $    $ #/
///##..*.# # #$ ##/
///#..*.# # # $  #/
####...#  #    # #/
#  ## #          #/
# @$ $ ###  # # ##/
# $   $   # #   #//
###$$   # # # # #//
//#   $   # # #####
//# $# #####      #
//#$   #///#   #  #
//#  ###///##     #
//#  #//////#    ##
//####//////######/