////////#####/////////////
////////#   ####//////////
////////# $    ####  ####/
////////#   # $#  ####  #/
########### #   $   #   #/
#..     # $  #### #  #  #/
#..$  #   $  #  $ # $ .##/
#.*# # $ $ ##  ##    #.#//
#..#$ @ #   ##    $$ #.#//
#..# $ $  $ $ ##   ## .#//
#.*$$ # ##   $ #$# $ #.#//
#..#      ##   #     #.#//
#..#######  ### ######.##/
# $$                  *.##
#  ##################  ..#
####////////////////######