///////#####/
/#######   ##
## # @## $$ #
#    $      #
#  $  ###   #
### #####$###
# $  ### ..#/
# $ $ $ ...#/
#    ###...#/
# $$ # #...#/
#  ### #####/
####/////////